Tok Wikipedia Redirects Resolved
============================================================

Total redirects: 64

ijo lawa → ijo ni li lon sijelo li ken ante e nasin sijelo e pilin
ijo leko → ijo pi sinpin luka wan pi palisa luka luka tu pi nena luka tu wan → leko tomo
ijo lili → wan lili
ijo lon → ijo wile
ijo sijelo → ijo wile
ilo kipisi → ilo
ilo suno → suno
jan nasa → sitelen Parahumans
jan pali → pali
jan sama → jan pi mama sama
kule kasi → laso
linja sike → sitelen pona
lipu toki → lipu
luka luka → nanpa 10
luka luka luka → nanpa 15
luka luka tu → nanpa 12
luka luka tu tu → nanpa 14
luka luka tu wan → nanpa 13
luka luka wan → nanpa 11
luka tu → nanpa 7
luka tu tu → nanpa 9
luka tu wan → nanpa 8
luka wan → nanpa 6
ma ale → ma
ma ali → ma
meli tonsi → tonsi
mije tonsi → tonsi
nasin nanpa → nanpa
nasin sitelen → sitelen toki
nena kute → kute
nena mama → nena pi sinpin sijelo
poki lili → poki sijelo lili
sona sijelo → sona pi sijelo ijo
suno sama → lipu su
tomo moku → tomo esun moku
a → sitelen A
e → sitelen E
kokosila → nimi:kokosila
ku → lipu ku
mi → nimi:mi
misikeke → ijo pi pona sijelo
n → sitelen N
nasa → ike lawa
ni → nimi:ni
o → sitelen O
oko → lukin
ona → nimi:ona
pu → lipu pu
sina → nimi:sina
suli → suli kiwen → suli ijo
ali → ale
jonke → waso telo
kisa → soweli Peli Katu
kutopoma → kulupu pi toki pona pi ma Anku
linluwi → kulupu pi ilo sona
majuna → tenpo pini
melome → meli pi olin meli
mulapisu → pan kili pi ma Italija
nimisin → nimi sin
nja → soweli Peli Katu
soto → poka open
su → lipu su
sutopatikuna → soweli pi uta waso
teje → poka pini
